
#######.......#######
....................#
....................#
....................#
....................#
....................#
......###############
......#......########
......#.........#####
..................###
.....................
.....................
..............#......
..............#......
###......######......
###.....###..........
########.............
######...............
#....................
#....................
#######.......#######
